#tiles
4;
0=1,1;
1=1,2;
2=22,4;
3=10,11;
#fill
4;
0=e;
1=f;
2=f;
3=e;
#map
25 19;
0000000000000000000000000
0000000010000000000000000
0000000000001000000000000
0000000000000000000000000
0001000000000000000000000
0000000000000111000000000
0000000011122222200000000
0000001112222111000000000
0000001111122220000000000
0000000000000000000000000
0000000000000000010000000
0000000000000000000000000
0001000000000000000000000
0000000000000000000333333
0000000000000000033333222
0000000033333333332222222
0003333333333222222222222
3333333322222222222222222
3333322222222222222222222
#EOF
